....._o__......
.....____......
....__.__......
....__._S......
...__..........
..__o________..
.._________o_..
...........__..
..EE_______o_..
..EE_________..
