_________vvvvv.
_S_______ovvv_.
___________v__.
..........___..
.>E<......___..
.___......o<_..
__^_______<<_..
_^^^o____<<<_..
^^^^^_____<<_..
.........._<_..
