S.o____<______o
_._..........._
_._.o__<____o._
_._._......._._
v.v._....EE._._
_._.o____EE.^.^
_._........._._
_.o____>____o._
_............._
o______>______o

