.S__<.<<<<<<EE.
.___<<<<<<.<EE.
.__.........o_.
._o.._____..__.
.__.._____.._o.
.o_.._o.__..__.
.__..__._o..__.
.___o__.___o__.
.______.______.
...............
